111111111111111111111111111111111111111111111
1P000C00000000000000000000000000C000000000001
100000000000000000C00000000000000000000000C01
100000011000000001100000000110000000011000001
100001111110000111111000011111100001111110001
100001111110000111111000011111100001111110001
1000000000000000000C0000000000000000000000001
1000000C000000C00000000000000C000000000000001
111111111111111111111111111111111111111111111