111111111111111111111111111111111111111111111111111
1P000C00000C000000000C0000000C0000000000000000000E1
100011C00000001100000000110000000011C00C00001100001
101111110000111111000011111100001111110000111111001
101111110000111111000011111100001111110000111111001
101111110000111111000011111100001111110000111111001
1000000C00000000C00000000000000000000000000C0000001
1000C00000C000000000000000C000000000C00000000C00001
111111111111111111111111111111111111111111111111111