1111111111111111111111111111111111
1E000000Y000000C00000C000000000001
10100101Y0100000101001000000010101
1010010010101010Y01001000000010101
1P0000Y00C00C00000000YYY0000000YC1
1111111111111111111111111111111111